11 14
  ************
* *          * 
* ******** * *
* **       * *
* *******  * *
* ***      * *
* *****   ** *
* ****   *** *
* **    **** *
*     ****** *
************  