18 28
 ***************************
  *          * *****      **
*   **** *****       ****  *
* ***        * **********  *
*     ******** *       **  *
*** ***      * * *** *     *
*       ****** * * * *******
*              * * * * * * *
**************** * * * * * *
***                *** * * *
*   **** ***** *****       *
* ***        ******* **** **
*     ***** **       *    **
*** ***      * ******* *****
*       ****** *       *   *
** *********   *** ******* *
*            ***           *
**************************  