11 10
  ********
*        *
******** *
*        *
* ********
*        *
******** *
*        *
* ********         
*        *
********  