 *************************************************
            * *****      *** ***        ******* **
*  **** *****       ****  **** *        * ********
** *        ************  *        * *****      **
*  * ****** * *       **  ********          * * **
******      * * * * *     **** *        * ********
*      ****** * * * ******** ***        ******* **
****        * ***** ***          *****      **   *
*********** ******* ********   **** ***** *****  *
**                  * * * *        * *****      **
*  **** ***** *****       **** ***      *      ***
* **        ******* **** ***   **** ***** *****  *
*    ***** **       *             * *****      ***
** ***      * *************        *******      **
*    **********       *   ** ***        ***** ****
* *********   *** ******* **       * ** **      **
*      *****  ***           *                    *
*           * ******     *********      **********
*  **** *****       ****  *        *******      **
****        * **********             *          **
*    **** *** *       **  ************ ** *****  *
**          * * *** *                  **         
************************************************* 

Solved Maze: 
#*************************************************
########    * *****      *** ***        ******* **
*  ****#*****       ****  **** *        * ********
** *   #####************  *        * *****      **
*  * ******#* *       **  ********          * * **
******######* * * * *     **** *        * ********
*     #****** * * * ******** ***        ******* **
****  ######* ***** ***          *****      **   *
***********#******* ********   **** ***** *****  *
**         #########* * * *        * *****      **
*  **** ***** *****###### **** ***      *      ***
* **        ******* ****#***###**** ***** *****  *
*    ***** **       *   ##### ####* *****      ***
** ***      * *************      ##*******      **
*    **********       *   ** ***  ######***** ****
* *********   *** ******* **       * **#**      **
*      *****  ***           *      #####         *
*           * ******     *********######**********
*  **** *****       ****##* #######*******######**
****        * **********###########  *#####    #**
*    **** *** *       **##************#** *****##*
**          * * *** *    ##############**       ##
*************************************************#
