23 50
 *************************************************
            * *****      *** ***        ******* **
*  **** *****       ****  **** *        * ********
** *        ************  *        * *****      **
*  * ****** * *       **  ********          * * ** 
******      * * * * *     **** *        * ********
*      ****** * * * ******** ***        ******* **
****        * ***** ***          *****      **   *
*********** ******* ********   **** ***** *****  *   
**                  * * * *        * *****      **
*  **** ***** *****       **** ***      *      *** 
* **        ******* **** ***   **** ***** *****  *   
*    ***** **       *             * *****      ***
** ***      * *************        *******      **
*    **********       *   ** ***        ***** ****
* *********   *** ******* **       * ** **      **
*      *****  ***           *                    *
*           * ******     *********      **********
*  **** *****       ****  *        *******      **
****        * **********             *          **
*    **** *** *       **  ************ ** *****  *
**          * * *** *                  **          
************************************************* 

